234142123
1XXXXXXX9
aXXXXXXXb
X2XXXXX1X
XX3XXX3XX
XXX2X2XXX
XXXX3XXXX