a32137X92b
12bXX1X19X
XcdeXXXXXX
1219182511
f7gXX1X7jX
Xh13X1i4XX
